卜	bjiooo
卜	bliooo
匕	bkuaaa
八	bsuooo
贝	bwiauo
勹	bzuaaa
艹	cziivv
刁	dcavvv
丁	dgviii
呆	dhovvv
刀	dzauuu
水	ebaaaa
手	ediuiu
虵	eeiaai
术	ejvooo
术	qjvooo
十	ekuouo
士	ekvovo
匚	fpvaaa
札	fsvaaa
个	geiiii
金	jbioio
厂	jpvuuu
九	jquaaa
口	kdoooo
林	lbvvvv
了	lcaiii
了	leaiii
〇	lgoooo
力	lkauuu
吕	lloooo
乜	mdaaaa
乜	ndaaaa
沐	mjavvv
木	mjvvvv
乃	nhauuu
朋	pruuuu
七	qkvaaa
碁	qkvivv
入	rjuooo
日	rkoiii
人	rniiii
厶	skaooo
土	tjvovo
觍	tmiaia
氽	twiaaa
杏	xgvooo
二	xjvvvv
儿	xjuaaa
休	xqivvv
吅	xtoooo
又	ydaooo
月	yhuavv
曰	yhoioi
乙	ykaaaa
亿	ykiaaa
乂	ykuooo
一	ykvvvv
甴	fsiaiv
